####################
# x  #  #     #    #
#    #  #  o  #    #
###  #  #     #    #
#       #     #    #
#####   ###  ###  ##
#     o            #
#   #   #### ##    #
#####   #     #    #
#       #     #    #
# #     ##   ##    #
# #                #
# #     o          #
# #  #######  #    #
#p            #    #
####################